11111111111111111111111111111111111111111111111
1E0000000000000C00000C0000000000011111111111111
10100101001000001010010000000101010000000001111
10100100101010100010010000000101011100000000011
1P0000000C00C0000000000000000000C11110000000001
11111111111111111111111111111111111111111111111