1111111111111111111111111111111111
1E0000000000000C00000C000000000001
1011010111100000101001000000010101
1010010111101010001001000000010101
1P0000000C00C0000000000000000000C1
11000000C00C0000000000000000000C01
11000000C00C0000000000000000000C01
110C0000C00C0000000000000000000C01
1100000001111100000000011101010101
1111111111111111111111111111111111