1111111
1E00C01
10PP0C1
1111111