111111
1E0C01
101001
1C11P1
111111