111111
1E00C1
111011
1P1001
111111