111111
1E00C1
101011
1P1001
111111