111111
100C01
1E0101
1P1001
111111