111111
1011C1
1C0C01
1P10E1
111111